55555555555700000000000000000000000000000000000000000000000000000000000000000000000000000000000000000000000000000000000000000000000000000000000000000000000000000000000000000000000000000000655555555555
55555555555700000000000000000000000000000000000000000000000000000000000000000000000000000000000000000000000000000000000000000000000000000000000000000000000000000000000000000000000000000000655555555555
55555555555700000000000000000000000000000000000000000000000000000000000000000000000000000000000000000000000000000000000000000000000000000000000000000000000000000000000000000000000000000000655555555555
55555555555700000000000000000000000000000000000000000000000000000000000000000000000000000000000000000000000000000000000000000000000000000000000000000000000000000000000000000000000000000000655555555555
55555555555700000000000000000000000000000000000000000000000000000000000000000000000000000000000000000000000000000000000000000000000000000000000000000000000000000000000000000000000000000000655555555555
55555555555700000000000000000000000000000000000000000000000000000000000000000000000000000000000000000000000000000000000000000000000000000000000000000000000000000000000000000000000000000000655555555555
55555555555700000000000000000000000000000000000000000000000000000000000000000000000000000000000000000000000000000000000000000000000000000000000000000000000000000000000000000000000000000000655555555555
55555555555700000000000000000000000000000000000000000000000000000000000000000000000000000000000000000000000000000000000000000000000000000000000000000000000000000000000000000000000000000000655555555555
55555555555700000000000000000000000000000000000000000000000000000000000000000000000000000000000000000000000000000000000000000000000000000000000000000000000000000000000000000000000000000000655555555555
55555555555700000000000000000000000000000000000000000000000000000000000000000000000000000000000000000000000000000000000000000000000000000000000000000000000000000000000000000000000000000000655555555555
55555555555700000000000000000000000000000000000000000000000000000000000000000000000000000000000000000000000000000000000000000000000000000000000000000000000000000000000000000000000000000000655555555555
55555555555700000000000000000000000000000000000000000000000000000000000000000000000000000000000000000000000000000000000000000000000000000000000000000000000000000000000000000000000000000000655555555555
55555555555700000000000000000000000000000000000000000000000000000000000000000000000000000000000000000000000000000000000000000000000000000000000000000000000000000000000000000000000000000000655555555555
55555555555700000000000000000000000000000000000000000000000000000000000000000000000000000000000000000000000000000000000000000000000000000000000000000000000000000000000000000000000000000000655555555555
55555555555700000000000000000000000000000000000000000000000000000000000000000000000000000000000000000000000000000000000000000000000000000000000000000000000000000000000000000000000000000000655555555555
55555555555700000000000000000000000000000000000000000000000000000000000000000000000000000000000000000000000000000000000000000000000000000000000000000000000000000000000000000000000000000000655555555555
55555555555700000000000000000000000000000000000000000000000000000000000000000000000000000000000000000000000000000000000000000000000000000000000000000D0000D000000000000000000000000000000000655555555555
55555555555700000000000000000000000000000000000000000000000000000000000000000000000000000000000000000000000000000000000000000000000000000000000000000344444200000000000000000000000000000000655555555555
55555555555700000000000000000000000000000000000000000000000000000000000000000000000000000000000000000000000000000000000000000000000000000008888800000655555700000000000000000000000000000000655555555555
55555555555700000000000000000000000000000000000000000000000000000000000000000000000000000000000000000000000000000000000000000000000000990000000000000655555700000000000000000000000000000000655555555555
55555555555700000000000000000000000000000000000000000000000000000000000000000000000000000000000000000000000000000000000000000000000000000000000000000655555700000000000000000000000000000000655555555555
55555555555700000000000000000000000000000000000000000000000008888000000000000000000000000000000000000000000000000000000000000000000000000000000000000655555700000000000000000000000000000000655555555555
55555555555700000000000000000000000000000000000000000000990000000000000000000000000000000000000000000000000000000000000000000000000000000000000000000655555700000000000000000000000000000000655555555555
5555555555570000000000000000000000000000000000000000000000000000000000000000000000000000000000000000000000000000000000000000000000000000000D000000000655555700000000000000000000000000000000655555555555
55555555555700000000000000000000000000000000000000000000000000000000000000000000000000000000000000000000000000000000000000000000000000000003444200000655555700000000000000000000000000000000655555555555
55555555555700000000000000000000000000000000000000000000000000000000000000000000000000000000000000000000000000000000000000000000000000000006555700000655555700000000000000000000000000000000655555555555
5555555555570000000000000000000000000000000000000000000000000D000000000000000000000000000000000000000000000D00000000000000000000000000099006555700000655555700000000000000000000000000000000655555555555
55555555555700000000000000000000000000000000000000000000000003442000000000000000000000000000000000000000000344200000000000000000000000000006555700000655555700000000000000000000000000000000655555555555
55555555555700000000000000000000000000000000000000000000000006557000000000000000000000000000000000000000000655700000000000000000000000000006555700000655555700000000000000000000000000000000655555555555
55555555555700000000000000000000000000000000000000000000000006557000000000000000000000000000000000000000000655700000000000000000000000000006555700000655555700000000000000088000000000000000655555555555
555555555557000000000000000000000000000000000000000000000000065570000000000000000D0000000000000000000800000655700000000000000000000088000006555700000655555700000000000000000000000000000000655555555555
55555555555700000000000000000000000000000000000000000000000006557000000000000000034200000000000000000000000655700000000000000000000000000006555700000655555700000000000000000000000000000000655555555555
55555555555700000000000000000000000000D00000000000000000000344444420000000000000065700000000000000000000000655700000000000000000000000000006555700000655555700000000000000000000000000000000655555555555
55555555555700000000000000000000000000344200000000000000000655555570000000000000065700000000000000000000000655700000000000000000000000000006555700000655555700000000000000088000000000000000655555555555
5555555555570000000000000000000000000065570000000000000000065555557000000009900006570000000000000000000000065570000000000000000000000000000655570000065555570000000000000000000000000A000000655555555555
5555555555570000000000000000000000000065570000000000342000065555557000000000000006570000000000000000342000065570000000000000000000003200000655570000065555570000000000000000000000000B000000655555555555
5555555555570000000000000000000000000065570000000000657000065555557000000000000006570000000000000000657000065570000000000000000000006700000655570000065555570000000000000000000000000B000000655555555555
5555555555570000000000000000000000003444444200000000657000065555557000000000000006570000000000000000657000065570000000000000000000006700000655570000065555570000000000000009900000000B000000655555555555
5555555555570000088880000000000000006555555700000000657000065555557000000000000006570000000000000000657000065570000000000000032000006700000655570000065555570000000000000000000000000B000000655555555555
555555555557000000000000000C000000006555555700000003444200065555557000000000000034442000000000000000657000065570000000000000067000006700000655570000065555570000000000000000000000000B000000655555555555
5555555555570000000000000003442000006555555700000006555700065555557000000000000065557000000000000034444420065570000000000000067000006700000655570000065555570000000000000000000000000B000000655555555555
5555555555570000000000000006557000006555555700C000065557000655555570000003420000655570000C0C000000655555700655700000003200000670000067000006555700000655555700000000C0000000000000000B000000655555555555
44444444444444444444444200065570000065555557003200065557000655555570000006570000655570000344200000655555700655700000006700000670000067000006555700000655555700000000344200000000344444444444444444444444
55555555555555555555555700065570000065555557006700065557000655555570000006570000655570000655700000655555700655700000006700000670000067000006555700000655555700000000655700000000655555555555555555555555
55555555555555555555555700065570000065555557006700065557000655555570000006570000655570000655700000655555700655700000006700000670000067000006555700000655555700000000655700000000655555555555555555555555
55555555555555555555555700065570000065555557006700065557000655555570000006570000655570000655700000655555700655700000006700000670000067000006555700000655555700000000655700000000655555555555555555555555
55555555555555555555555700065570000065555557006700065557000655555570000006570000655570000655700000655555700655700000006700000670000067000006555700000655555700000000655700000000655555555555555555555555
55555555555555555555555700065570000065555557006700065557000655555570000006570000655570000655700000655555700655700000006700000670000067000006555700000655555700000000655700000000655555555555555555555555
55555555555555555555555700065570000065555557006700065557000655555570000006570000655570000655700000655555700655700000006700000670000067000006555700000655555700000000655700000000655555555555555555555555
55555555555555555555555700065570000065555557006700065557000655555570000006570000655570000655700000655555700655700000006700000670000067000006555700000655555700000000655700000000655555555555555555555555